1111111111
1000010001
1101010101
1001000111
1010010001
1001011101
1101000111
1100110101
1110110001
1110111111
